2 2 2 2 2 2 2 2 2 2 2 2 2 2 2 2
2 0 0 0 3 0 0 0 0 0 0 0 0 0 0 2
2 0 0 0 0 0 0 3 3 3 3 0 0 0 0 2
2 0 0 0 3 0 0 0 0 0 0 0 0 0 0 2
2 0 0 0 0 2 0 0 3 0 0 2 0 0 0 2
2 0 2 0 0 0 0 0 0 0 0 0 0 0 0 2
2 0 0 0 0 0 6 1 1 0 0 0 0 0 0 2
2 2 0 3 4 6 6 1 1 0 0 0 2 0 0 2
2 0 0 0 0 6 6 6 6 6 6 6 6 6 6 6
2 0 2 5 5 5 5 3 0 0 0 2 6 6 6 6
2 2 5 1 1 1 1 5 0 0 0 0 0 0 0 2
2 1 1 1 1 1 1 1 1 1 1 1 1 1 1 2

