0 0 0 0 0 0 0 0 0 0 0 0 0 0 35 36 3 0 0 0 0 0 0 0 0 0 0 0 0 0 0 0 0 0 0 0 0 0 0 0 0 0 0 0 0 0 0 0 0 0 
0 0 0 0 0 0 0 0 0 0 0 0 0 0 44 45 3 3 0 3 0 0 0 0 0 0 0 0 0 0 0 0 0 0 0 0 0 0 0 0 0 0 0 0 0 0 0 0 0 0 
0 0 0 0 0 0 0 0 0 0 0 0 0 0 0 0 0 46 47 0 0 0 0 0 0 0 0 0 0 0 0 0 0 0 0 0 0 0 0 0 0 0 0 0 0 0 0 0 0 0 
0 0 0 0 0 0 0 0 0 0 0 0 0 3 0 0 48 49 50 51 0 31 32 0 0 0 0 0 0 0 0 0 0 0 0 0 0 0 0 0 3 0 0 0 3 3 3 0 0 0 
0 0 0 0 0 0 0 0 0 0 0 0 3 3 0 0 52 53 54 55 0 0 0 0 0 0 0 0 0 0 0 0 0 0 0 0 0 0 0 3 3 0 0 0 0 0 3 3 0 0 
0 0 0 0 0 0 0 0 0 0 0 0 3 3 0 0 0 56 57 58 0 0 0 0 0 0 0 0 0 0 0 0 0 0 0 0 3 0 0 0 0 0 0 0 0 0 0 3 0 0 
0 0 0 0 0 0 0 0 0 0 0 0 0 0 0 3 0 0 0 0 0 0 3 3 3 0 0 0 0 0 0 0 0 0 0 0 0 0 0 0 0 19 20 21 0 0 0 3 0 0 
0 0 0 0 0 0 0 0 0 0 0 0 0 0 0 3 0 0 0 0 3 3 3 0 3 0 0 0 0 0 0 0 0 0 0 0 3 0 0 0 0 22 24 25 0 0 0 3 0 0 
0 0 0 0 0 0 0 0 0 0 0 0 0 0 0 0 0 0 0 0 0 0 0 0 0 0 0 0 0 0 0 0 0 0 0 0 0 0 0 0 0 28 29 30 0 0 0 0 0 0 
0 0 0 0 0 0 0 0 0 0 0 0 0 0 0 0 0 0 0 0 0 0 0 0 0 0 0 0 0 0 0 0 0 0 0 0 0 0 3 3 0 37 38 39 0 0 0 3 3 0 
0 0 0 0 0 0 0 0 0 0 0 0 0 0 0 0 0 0 0 0 0 0 0 0 0 0 0 0 0 0 0 0 0 0 0 3 0 3 0 0 0 0 0 0 18 0 0 0 3 3 
0 0 0 0 0 0 0 0 0 0 0 0 0 26 27 0 0 0 7 7 7 7 7 7 7 7 7 7 7 7 7 7 7 7 0 3 0 0 0 0 0 0 35 36 0 0 0 0 3 0 
0 0 0 19 20 21 0 0 0 0 0 0 0 0 0 0 0 0 7 8 8 8 8 8 8 8 8 8 8 8 8 8 8 7 0 0 0 0 0 0 0 0 44 45 0 0 0 0 0 0 
0 0 0 22 23 25 0 0 0 0 0 0 0 0 0 0 0 0 7 8 9 8 8 8 8 8 8 8 8 8 8 8 8 7 0 0 0 0 0 0 0 0 0 0 0 0 0 4 0 0 
0 0 0 28 29 30 0 0 26 27 0 0 0 0 0 0 0 0 7 8 8 9 9 8 8 8 8 8 8 8 8 8 8 7 3 0 4 0 0 0 0 3 0 0 0 0 0 0 0 0 
0 0 0 37 38 39 0 0 0 0 0 0 0 0 0 0 0 0 7 8 9 9 8 8 8 8 8 8 8 8 9 8 8 7 0 0 0 0 0 0 0 0 0 0 0 0 0 0 0 0 
0 0 0 0 0 0 0 0 0 0 0 0 0 0 0 0 0 0 7 8 8 8 8 8 8 8 8 8 8 9 9 8 8 7 0 0 0 0 0 0 0 0 0 0 0 0 0 0 3 0 
0 0 0 0 0 0 0 0 0 0 0 0 0 0 0 0 0 0 7 8 8 8 8 8 8 8 8 8 8 8 8 9 8 7 0 3 3 0 0 0 0 0 0 0 3 0 3 3 0 0 
0 26 27 0 0 3 0 0 0 0 0 0 0 0 0 0 0 0 7 8 8 8 8 8 8 8 8 8 8 8 8 8 8 7 0 3 0 0 0 0 0 0 0 0 0 0 0 0 0 0 
0 0 0 0 3 3 0 0 0 0 0 0 0 0 0 0 0 0 7 7 7 7 7 7 7 8 7 7 7 7 7 7 7 7 0 3 0 4 4 0 0 3 0 0 0 3 0 0 0 0 
0 0 0 0 3 0 0 0 0 26 27 0 0 0 0 3 0 0 7 8 8 8 8 8 8 8 8 8 8 8 8 8 8 7 0 3 3 4 0 0 0 3 3 0 0 0 3 0 0 0 
0 0 0 0 3 3 0 0 0 33 34 0 0 0 0 0 0 0 7 8 9 8 8 8 8 8 8 8 8 8 8 8 8 7 0 0 0 0 0 0 0 3 3 3 3 3 3 0 0 0 
0 0 0 0 0 0 0 0 0 42 43 0 0 3 0 0 0 0 7 8 9 8 8 8 8 8 9 8 8 8 8 8 9 7 0 0 0 0 0 0 0 0 0 0 0 0 0 0 0 0 
0 0 0 0 0 0 0 0 0 0 0 0 3 3 0 0 0 0 7 8 8 8 8 8 8 9 9 8 8 8 8 8 8 7 0 0 0 0 0 0 0 0 0 0 0 0 0 0 0 0 
0 0 0 3 3 0 0 0 0 0 0 0 0 0 0 0 0 0 7 8 8 8 8 8 8 8 8 8 8 8 8 8 8 7 0 0 0 0 0 0 0 0 0 0 0 0 0 0 0 0 
0 0 3 0 0 0 0 0 0 0 0 0 0 0 0 0 0 0 7 8 8 8 8 8 8 8 8 8 8 9 8 8 8 7 0 0 0 0 0 0 0 0 0 0 0 3 3 0 0 0 
0 0 0 0 0 0 0 0 0 0 0 3 3 3 0 0 0 0 7 8 8 8 8 8 8 8 8 8 8 8 8 8 8 7 0 0 0 0 0 0 3 0 3 3 3 0 0 0 0 0 
0 0 0 0 0 0 0 0 0 0 0 0 0 0 0 0 0 0 7 7 7 7 7 7 7 7 7 7 7 7 7 8 7 7 7 7 7 7 7 7 7 7 7 7 7 0 0 0 0 0 
0 0 0 3 3 3 0 0 0 0 0 0 0 0 0 0 0 0 0 0 0 0 0 0 0 0 0 0 0 7 8 8 8 8 8 8 8 8 8 8 8 8 8 8 7 0 0 0 0 0 
0 0 3 3 0 0 0 0 0 0 0 3 0 0 0 0 0 0 2 0 0 0 0 0 0 0 0 0 0 7 8 9 8 8 8 8 9 8 8 8 8 8 8 8 7 3 3 3 3 3 
3 0 3 0 0 0 0 0 0 0 0 3 0 0 0 0 0 0 2 0 0 0 0 0 0 0 0 0 0 7 8 8 8 8 8 8 9 8 8 8 8 8 8 8 7 0 0 0 0 0 
3 3 0 0 0 0 0 0 0 0 3 3 0 0 0 0 3 3 0 0 0 0 0 0 3 3 0 0 0 7 8 8 9 8 8 8 8 8 8 8 8 8 8 8 7 0 0 0 0 0 
0 0 0 0 0 0 0 0 0 0 0 0 0 0 0 0 0 3 3 0 0 0 0 0 3 0 0 0 0 7 8 8 8 8 8 8 8 8 8 8 8 8 8 8 7 0 0 0 0 0 
0 0 0 0 0 0 0 0 0 0 0 0 0 0 0 0 0 0 3 3 0 0 0 0 0 0 0 0 0 7 7 7 7 7 7 7 7 7 0 7 7 7 7 7 7 0 0 0 0 0 
0 0 0 0 0 0 0 0 0 0 0 0 0 0 0 0 2 0 0 0 0 0 0 0 0 0 0 0 0 0 0 0 0 0 0 0 0 0 0 0 0 0 0 0 0 0 0 0 0 0 
0 0 0 0 0 0 0 0 0 0 3 0 0 0 0 0 0 0 0 3 3 3 0 0 0 0 3 0 0 0 0 0 0 0 0 0 0 0 0 0 0 0 0 0 0 0 0 0 0 0 
0 0 0 0 0 0 0 0 0 0 0 3 0 0 0 0 0 0 0 0 0 0 0 3 0 0 0 0 0 0 0 0 0 0 0 0 0 0 0 0 0 0 0 0 0 0 0 0 0 0 
0 0 0 0 0 0 3 3 0 0 0 0 0 0 0 3 0 0 0 0 0 0 0 3 3 0 0 0 0 0 0 0 0 0 0 0 0 0 0 0 0 0 0 0 0 0 0 0 0 0 
0 0 0 0 0 0 0 0 0 0 0 0 3 3 0 3 0 0 0 0 0 0 0 0 0 0 0 0 0 0 0 0 0 0 0 0 0 0 0 0 0 0 0 0 0 0 0 0 0 0 
0 0 0 0 0 0 0 3 0 0 0 0 0 0 0 0 0 0 0 0 0 0 0 0 0 0 0 0 0 0 0 0 0 0 0 0 0 0 0 0 0 0 0 0 0 0 0 0 0 0 
0 3 0 0 0 3 3 3 0 0 0 0 0 0 0 0 0 0 0 0 0 0 0 0 0 0 0 0 0 0 0 0 0 0 0 0 0 0 0 0 0 0 0 0 0 0 0 0 0 0 
3 3 3 3 3 0 0 0 0 0 0 3 3 0 0 0 0 0 0 0 0 0 0 0 0 0 0 0 0 0 0 0 0 0 0 0 3 0 0 0 0 0 0 0 0 0 0 0 0 0 
3 3 3 0 0 0 0 0 0 0 0 0 0 0 0 0 0 0 0 0 0 0 0 0 0 0 0 0 0 0 0 0 0 0 0 3 3 0 0 0 0 0 0 0 0 0 0 0 0 0 
0 0 0 0 0 0 0 0 0 0 0 0 0 0 0 0 0 0 0 0 5 5 0 0 0 0 0 0 0 0 0 0 0 0 0 3 3 3 3 0 0 2 0 0 0 2 2 0 0 0 
11 11 11 11 15 0 0 0 0 0 0 0 0 0 0 0 0 0 0 0 5 5 5 5 0 0 0 5 5 0 0 0 0 0 0 3 3 3 3 0 0 0 0 2 0 0 0 0 0 0 
1 1 1 1 13 0 0 0 0 0 0 0 0 0 0 0 0 5 5 0 5 5 5 5 5 5 5 5 0 0 0 0 0 0 0 0 0 0 0 0 2 0 0 2 0 0 2 0 0 0 
1 1 1 1 13 0 0 0 0 0 0 0 0 0 0 0 0 0 5 5 5 5 5 5 5 5 5 5 5 5 0 5 0 0 0 0 0 0 0 4 0 0 0 0 0 2 0 0 0 4 
1 1 1 1 10 11 11 11 11 11 11 11 11 11 11 11 15 0 0 5 5 5 5 5 5 5 5 5 5 5 5 5 5 0 0 0 0 0 2 2 0 2 2 0 0 0 0 0 0 0 
1 1 1 1 1 1 1 1 1 1 1 1 1 1 1 1 13 0 0 5 5 5 5 5 5 5 5 5 5 5 5 5 5 5 0 0 0 0 0 0 0 0 0 2 0 0 0 2 0 0 
1 1 1 1 1 1 1 1 1 1 1 1 1 1 1 1 13 0 0 5 5 5 5 5 5 5 5 5 5 5 5 5 5 5 5 5 0 2 0 0 0 2 0 0 0 4 0 0 0 0 
